11111111111111111111111111111111
10000000000000000000000000000001
100000000000C0000001100000000001
10000000000000000010111100000001
1000000C000000000010010000000001
100000000000E0000000011100000001
100000C0000000000000000000000001
100000C00P000000000000000000C001
11111111111111111111111111111111
