111111111111111111111111111111111111111
10C000000000000000000000000000000000PE1
111111111111111111111111111111111111111
