11111111111111111111111111111111111111
1000000000000CCCCCCC0CCCCCCCCCCCCCCC01
10E0000000CCC1111111C111111111111111C1
10000000CC11111111CCC1111CCCCCC11111C1
10000CCC1111111CCC0C111CC0000C11111C01
100CC11111111CC0000C11C00CCC1111111C01
10C1111111CCC0000000CC00C11111111CC001
1C111111CC0000000000000C111111CCC00C01
1C1111CCCCCCCCCCCCCC00C11111CC0000C1C1
1C111111111111111111CC11111C0000CC11C1
1C111111111111111111C11111C0000C1111C1
1C111111111111111111C1111C0000C11111C1
10CCCCCCCCCCCCC11111C111C000CC111111C1
10000000000000C11111C11CCCCC11111111C1
1000000000000PC11111C111111111111111C1
10000000000000C11111CCCCCCCCCCCCCCCCC1
11111111111111111111111111111111111111